CharacterInteraction/&BanditTrackDescription	Human tracks - probably bandits. They look quite fresh.
CharacterInteraction/&DisarmTrapDescription	Click to try to disarm this trap.
CharacterInteraction/&HardClimbDescription	Click to try to climb.
CharacterInteraction/&LightDescription	Click to light this light.
CharacterInteraction/&LockPickChestDescription	Click to try to pick the lock on this chest.
CharacterInteraction/&LockPickDoorDescription	Click to try to pick this door's lock.
CharacterInteraction/&LootContainerDescription	Click to loot this container.
CharacterInteraction/&NpcInteractionDescription	Click to interact with this character.
CharacterInteraction/&ObserveDescription	Click to examine this object.
CharacterInteraction/&OpenCloseDoorDescription	Click to open/close this door.
CharacterInteraction/&PushDescription	Click to push this object.
CharacterInteraction/&StartLongRestDescription	Click to start a long rest for the party.
CharacterInteraction/&TriggerTrapDescription	Trigger collapse.
CharacterInteraction/&UseDescription	Click to use this object.
CharacterInteraction/&GoblinTrackDescription	Footprints… Probably goblins'. They look quite fresh.
CharacterInteraction/&UnknownTrackDescription	Fresh tracks, probably those of the fanatics.
CharacterInteraction/&SorakTrackDescription	Reptilian tracks… Soraks, maybe?
CharacterInteraction/&QuickShoppingDescription	Click to open quick shopping.
CharacterInteraction/&WaitDescription	Click to wait for the moon to rise.
CharacterInteraction/&UseScavengersDescription	Click to use the Scavenger System
CharacterInteraction/&TakeScimitarDescription	Click to use the scimitar and the shield for this fight.
CharacterInteraction/&TakeDaggersDescription	Click to use the daggers for this fight.
CharacterInteraction/&TakeGreataxeDescription	Click to use the greataxe for this fight.
CharacterInteraction/&LeaveArenaDescription	Click to leave the arena and forfeit the duel.
CharacterInteraction/&PlantDocumentDescription	Plant Document
