Encounter/&Abjuration_Caravan_EncounterDescription	You came across a caravan, a rare thing in these desolate lands.
Encounter/&Abjuration_Caravan_EncounterTitle	Unexpected Encounter
Encounter/&Abjuration_Ruins01_EncounterDescription	As you traveled through the Badlands towards Coparann, Kythaela asked you to stop near an old ruin…
Encounter/&Abjuration_Ruins01_EncounterTitle	Ashes of Manacalon
Encounter/&Abjuration_Ruins02_EncounterDescription	Kythaela stopped again, and asked to enter what seems to be an old Imperial prison.
Encounter/&Abjuration_Ruins02_EncounterTitle	Dungeons of Manacalon
Encounter/&BadlandsSpidersEncounterDescription	You must have roamed close to a nest: a handful of these little monsters wants you dead.
Encounter/&BadlandsSpidersEncounterTitle	Badlands Spiders
Encounter/&BanditsEncounterDescription	Robbers in search of easy prey - preferably wealthy.
Encounter/&BanditsEncounterTitle	Bandits
Encounter/&CrownAttunementEncounterDescription	Your party is forced to stop for an unplanned short rest. Something is wrong.
Encounter/&CrownAttunementEncounterTitle	A Troubled Night
Encounter/&DeepSpidersEncounterTitle	Deep Spiders
Encounter/&EagleNestEncounterDescription	You've wandered too close to a nest! The eagles will fight to the death to protect their young!
Encounter/&EagleNestEncounterTitle	Eagle Nest
Encounter/&FlyingSnakesEncounterDescription	A bevy of flying snakes who want you away from their eggs.
Encounter/&FlyingSnakesEncounterTitle	Brimstone Vipers
Encounter/&GoblinCrusadersDescription	A goblin shaman and his followers in search of glory.
Encounter/&GoblinCrusadersTitle	Goblin Crusade
Encounter/&GoblinhuntingpartyEncounterDescription	Goblins on the hunt with their tame wolves.
Encounter/&GoblinhuntingpartyEncounterTitle	Goblin Hunting Party
Encounter/&GoblinWarPartyDescription	A band of goblin skirmishers looking for trouble.
Encounter/&GoblinWarPartyTitle	Goblin War Party
Encounter/&OrcMaraudersTitle	Orc Marauders
Encounter/&OrcRaidersDescription	An orc chieftain leading a band of warriors in search of scars and glory.
Encounter/&OrcRaidersTitle	Orc Raiders
Encounter/&WinterWolfpackEncounterDescription	A terrible winter wolf, on the hunt with a few normal wolves.
Encounter/&WinterWolfpackEncounterTitle	Winter Wolf and Pack
Encounter/&WolfpackEncounterDescription	A pack of ravenous wolves, desperate for a kill.
Encounter/&WolfpackEncounterTitle	Wolf Pack
Encounter/&DeepSpidersEncounterDescription	A huge party of deep spiders looking to feed their spiderlings.
Encounter/&DeathGangTitle	Death Gang
Encounter/&DeathGangDescription	Roaming skeletons, escaped from some desecrated tomb.
Encounter/&DeathSquadTitle	Death Squad
Encounter/&RoamingFanaticsTitle	Roaming Fanatics
Encounter/&RoamingFanaticsDescription	A couple of acolytes led by a charismatic leader.
Encounter/&ApprenticeNecromancerTitle	Apprentice Necromancer
Encounter/&ApprenticeNecromancerDescription	A student of magic with a bunch of his rotting creations.
Encounter/&SpiesOnTheRunTitle	Spies on the Run
Encounter/&SpiesOnTheRunDescription	A couple of spies trying to escape enemy intelligence… at all costs.
Encounter/&GlorySeekerTitle	Glory Seeker
Encounter/&GlorySeekerDescription	A veteran soldier roaming the roads in search for death on the battlefield.
Encounter/&BerserkerBrothersTitle	Berserker Brothers
Encounter/&BerserkerBrothersDescription	Like-minded fighters in search for blood. Preferably yours.
Encounter/&StainedHunterTitle	Stained Hunter
Encounter/&StainedHunterDescription	A lonely wanderer of the Badlands who's been corrupted by chaotic magic.
Encounter/&HungryWolvesTitle	Hungry Wolves
Encounter/&HungryWolvesDescription	A small pack of wolves, famished and weakened.
Encounter/&GoblinScoutsTitle	Goblin Scouts
Encounter/&GoblinScoutsDescription	A small group of goblins with their pet wolf.
Encounter/&LoneOgreTitle	Lone Ogre
Encounter/&LoneOgreDescription	A wandering ogre, probably lost and definitely looking for something - or someone - to eat.
Encounter/&OrcBandTitle	Orc Band
Encounter/&OrcBandDescription	A small bunch of orcs, looking for something to kill.
Encounter/&RoamingUndeadsTitle	Roaming Undeads
Encounter/&RoamingUndeadsDescription	A group of undeads, wandering around and looking to end a few lives.
Encounter/&EvilEvangelistsTitle	Evil Evangelists
Encounter/&EvilEvangelistsDescription	A cleric and his goons, roaming the land to spread their evil cult.
Encounter/&GhoulCoupleTitle	Ghouls
Encounter/&GhoulCoupleDescription	A band of ghouls with wicked hunger.
Encounter/&GiantEaglesTitle	Giant Eagles
Encounter/&GiantEaglesDescription	A couple of giant eagles that seem threatened by your presence.
Encounter/&WolfSquadTitle	Goblin Wolfsquad
Encounter/&WolfSquadDescription	A group of goblins led by a beastmaster and his dire wolf.
Encounter/&EscapedMinotaurTitle	Escaped Minotaur
Encounter/&EscapedMinotaurDescription	A rare creature on Solasta, this guardian aberration is on a killing spree.
Encounter/&LoneWightTitle	Wight
Encounter/&LoneWightDescription	A lone wight wandering in search of someone to kill.
Encounter/&ScoutingPartyTitle	Scout and Wolf
Encounter/&ScoutingPartyDescription	A sneaky scout and his wolf pet.
Encounter/&DireWolfPackTitle	Dire Wolf Pack
Encounter/&DireWolfPackDescription	A Dire Wolf and his pack of regular hunters.
Encounter/&DireWolfPack2Title	Dire Wolves
Encounter/&DireWolfPack2Description	A pack of dire wolves.
Encounter/&FanaticDuoTitle	Fanatic Duo
Encounter/&FanaticDuoDescription	A couple of fanatics on their way to a brutal pilgrimage.
Encounter/&MisayeEvangelistsTitle	Misaye Evangelists
Encounter/&MisayeEvangelistsDescription	A group of fanatic Misaye followers who have their own interpretations of their deity's creed.
Encounter/&OgreZombiesTitle	Ogre Zombies
Encounter/&OgreZombiesDescription	A group of dead ogres made into worse versions of their former selves.
Encounter/&OrcPartyTitle	Orc War Party
Encounter/&OrcPartyDescription	A bunch of orcs looking for scars and glory.
Encounter/&WightEscortTitle	Wight Squad
Encounter/&WightEscortDescription	A wight and his soldiers on a hunt for the living.
Encounter/&BeastmasterTitle	Ragged Beastmaster
Encounter/&BeastmasterDescription	A crazed man and his starving wolf companions.
Encounter/&GhastsTitle	Ghasts
Encounter/&GhastsDescription	A band of ghasts looking for souls to reap and bodies to devour.
Encounter/&GhoulPackTitle	Ghoul Pack
Encounter/&GhoulPackDescription	A ghast and his ghouls looking for souls to reap and bodies to devour.
Encounter/&WolfShamanTitle	Wolf Shaman
Encounter/&WolfShamanDescription	A goblin shaman and his pet dire wolf.
Encounter/&OgreBandTitle	Ogre Band
Encounter/&OgreBandDescription	A group of angry ogres.
Encounter/&LeatherskinsTitle	Leatherskins
Encounter/&LeatherskinsDescription	A heteroclite party of goblins accompanied by a dire wolf and an ogre.
Encounter/&CultFanaticsTitle	Cult Fanatics
Encounter/&CultFanaticsDescription	A band of crazed fanatics who believe in swords more than they believe in words.
Encounter/&WinterWolfPackTitle	Winter Wolf pack
Encounter/&WinterWolfPackDescription	A pack led by a monstrous winter wolf.
Encounter/&ZombiePartyTitle	Zombies
Encounter/&ZombiePartyDescription	Simply put, a band of wandering zombies in search of living flesh.
Encounter/&SlaversTitle	Slavers
Encounter/&SlaversDescription	Fanatics looking for prey to enslave.
Encounter/&NecromancerTitle	Necromancer Squad
Encounter/&NecromancerDescription	A necromancer and his creations on the warpath.
Encounter/&Leatherskins2Title	Leatherskins
Encounter/&Leatherskins2Description	A band of orcs led by an ogre.
Encounter/&FireNestTitle	Fire Nest
Encounter/&FireNestDescription	A bunch of fire spiders wandering out of their zone of comfort.
Encounter/&WarlordTitle	Warlord
Encounter/&WarlordDescription	A powerful warlord and his chaplain in search for a glorious battle.
Encounter/&ImperialsTitle	Imperial Outlaws
Encounter/&ImperialsDescription	New Empire combatants who decided to take it upon themselves to apply the law of the Old Empire.
Encounter/&MinotaursTitle	Minotaurs
Encounter/&MinotaursDescription	Wandering minotaurs looking for freedom and bloodshed.
Encounter/&ShadowPartyTitle	Shadow Party
Encounter/&ShadowPartyDescription	A group of sneaky individuals with great skills and sharp blades.
Encounter/&FallenBeastmasterTitle	Stained Beastmaster
Encounter/&FallenBeastmasterDescription	A ranger who's spent too much time in the Badlands, and became one more monster.
Encounter/&SharpshootersTitle	Sharpshooter Squad
Encounter/&SharpshootersDescription	A band of deadly archers looking to hone their skills on live targets.
Encounter/&ApostatesTitle	Apostates
Encounter/&ApostatesDescription	A band of crusaders whose faith has been lost after theirs were corrupted by evil magic.
Encounter/&OrcConquerorTitle	Orc Conquerors
Encounter/&OrcConquerorDescription	Another party of orc warchiefs trying to become kings of the Badlands.
Encounter/&BattleMageTitle	Battle Mage
Encounter/&BattleMageDescription	A powerful wizard and his escort, looking for foes to burn to ashes.
Encounter/&WarlordsTitle	Warmongers
Encounter/&WarlordsDescription	Powerful Fighters looking for anything to kill to become even more experienced.
Encounter/&CultLeaderTitle	Cult Leader
Encounter/&CultLeaderDescription	A powerful cleric with his personal escort, on a murderous mission.
Encounter/&SpectralSpidersTitle	Spectral Spiders
Encounter/&SpectralSpidersDescription	A group of undead giant spiders.
Encounter/&PhaseSpiderTitle	Phase Spider
Encounter/&PhaseSpiderDescription	A huge, nasty, teleporting spider.
Encounter/&PhaseSpidersTitle	Phase Spiders
Encounter/&PhaseSpidersDescription	A bunch of huge, nasty, teleporting spiders.
Encounter/&SpectralHunterTitle	Spectral Hunter
Encounter/&SpectralHunterDescription	An undead hunter and his undead pet wolf.
Encounter/&TigerDrakesTitle	Tiger Drakes
Encounter/&TigerDrakesDescription	Huge flying snakes resembling small dragons.
Encounter/&CR10_YoungRemorhazes_Title	Remorhazes
Encounter/&CR12_Redeemers_x3_Title	Group of Redeemers
Encounter/&CR15_Redeemers_x1_x2_Title	Zealot and Pilgrims
Encounter/&CR9_Minor_Fire_Elementals_Title	Minor Fire Elementals
Encounter/&CR14_Fire_Elementals_Title	Fire Elementals
Encounter/&CR18_Major_Fire_Elementals_Title	Major Fire Elementals
Encounter/&CR6_Minor_Air_Elementals_Title	Minor Air Elementals
Encounter/&CR12_Air_Elementals_Title	Air Elementals
Encounter/&CR7_Young_Black_Dragon_Title	Young Black Dragon
Encounter/&CR10_PoisonousPests_Title	Poisonous Pests
Encounter/&CR20_CrimsonSpiders_x4_Title	Crimson Spiders
Encounter/&CR16_Major_Earth_Elementals_Title	Major Earth Elementals
Encounter/&CR15_Elementals_x3_Title	Elemental Trio
Encounter/&CR10_Skeleton_Enforcers_x2_x2_Title	Skeletal Enforcers
Encounter/&CR17_Skeleton_Sorcerer_x1_x2x_2_Title	Skeletal Sorcerer and Escort
Encounter/&CR22_Skeletal_Devastators_x1_x2_x3_Title	Skeletal Devastators
Encounter/&CR10_CrimsonSpiders_x2_Title	Crimson Spider Couple
Encounter/&CR5_Goblin_Cutthroats_Title	Goblin Cutthroats
Encounter/&CR8_Goblin_Ravagers_Title	Goblin Ravagers
Encounter/&CR11_OrcGrimblade_x1_x2_x1_Title	Orc Grimblade Raider
Encounter/&CR9_Orc_Hunters_Title	Orc Hunting Party
Encounter/&CR10_Wraiths_Title	Wandering Wraiths
Encounter/&CR12_Necromancer_Gang_Title	Necromancer Gang
Encounter/&CR13_Brood_Couple_Title	Wandering Brood Couple
Encounter/&CR21_Brood_Horde_Title	Wandering Brood Horde
Encounter/&CR10_YoungRemorhazes_Description	A couple of young remorhazes… still deadly!
Encounter/&CR12_Redeemers_x3_Description	A trio of deadly giant insects looking for their next meal.
Encounter/&CR15_Redeemers_x1_x2_Description	A gigantic zealot and two lesser redeemers looking for magic to feed upon.
Encounter/&CR9_Minor_Fire_Elementals_Description	Small fiery elementals born from some chaotic Badlands magic.
Encounter/&CR14_Fire_Elementals_Description	Fiery elementals born from some chaotic Badlands magic.
Encounter/&CR18_Major_Fire_Elementals_Description	Very powerful fiery elementals born from some chaotic Badlands magic.
Encounter/&CR6_Minor_Air_Elementals_Description	Small air elementals born from some chaotic Badlands magic.
Encounter/&CR12_Air_Elementals_Description	Air elementals born from some chaotic Badlands magic.
Encounter/&CR7_Young_Black_Dragon_Description	This degenerate dragon was born in the Badlands. Now it's looking to kill something.
Encounter/&CR10_PoisonousPests_Description	A group of venomous Badlands creatures.
Encounter/&CR20_CrimsonSpiders_x4_Description	A group of giant spiders born in the acidic underground lakes of the Badlands.
Encounter/&CR16_Major_Earth_Elementals_Description	Small elementals born underground in the chaotic Badlands.
Encounter/&CR15_Elementals_x3_Description	Earth elementals born underground in the chaotic Badlands.
Encounter/&CR10_Skeleton_Enforcers_x2_x2_Description	A group of powerful skeletons summoned by an experienced necromancer.
Encounter/&CR5_Goblin_Cutthroats_Description	A band of goblin assassins with a hunger for blood.
Encounter/&CR8_Goblin_Ravagers_Description	A large group of experienced goblins on a path for blood.
Encounter/&CR11_OrcGrimblade_x1_x2_x1_Description	An orc raiding party led by a powerful orc grimblade.
Encounter/&CR9_Orc_Hunters_Description	A couple of orc beastmasters and their pets looking for easy prey.
Encounter/&CR10_Wraiths_Description	A band of deadly wandering Badlands wraiths looking for souls to torment.
Encounter/&CR12_Necromancer_Gang_Description	A powerful necromancer and his summoned creatures, looking for a challenge.
Encounter/&CR13_Brood_Couple_Description	Wandering broods in search of blood.
Encounter/&CR14_Arctic_Monsters_x3x1_Title	Arctic Monsters
Encounter/&CR9_Arctic_Pack_x3_Title	Arctic Pack
Encounter/&CR6_Arctic_Duo_x2_Title	Arctic Duo
Encounter/&CR16_Undead_Pack_x4_Title	Undead Pack
Encounter/&CR6_Wraith_Master_x1x4_Title	Wraith Master
Encounter/&CR16_Wraith_Hunters_x3x2_Title	Wraith Hunters
Encounter/&CR4_Undead_Knight_x1x2x2_Title	Undead Knight
Encounter/&CR8_Undead_Knight_x1x1x4_Title	Undead Huntsman
Encounter/&CR8_Undead_hunt_pack_x3_Title	Undead Pack
Encounter/&CR2_Wind_Snakes_x4_Title	Wind Snakes
Encounter/&CR6_Flying_Snakes_x6_Title	Flying Snakes
Encounter/&CR4_Skarn_Ghouls_x2_Title	Snark Ghouls
Encounter/&CR7_Grimblade_Title	Grimblade
Encounter/&CR8_Tamed_Minotaur_Title	Tamed Minotaur
Encounter/&CR14_Arctic_Monsters_x3x1_Description	A terrifying young remorhaz with a bunch of arctic predators scavenging after him.
Encounter/&CR9_Arctic_Pack_x3_Description	A small pack of winter wolves on the hunt.
Encounter/&CR6_Arctic_Duo_x2_Description	A couple of Winter Wolves on the hunt.
Encounter/&CR16_Undead_Pack_x4_Description	Undead wolves behaving like they're still alive and hunting.
Encounter/&CR6_Wraith_Master_x1x4_Description	An undead hunter and his pet.
Encounter/&CR16_Wraith_Hunters_x3x2_Description	A powerful band of undead warriors.
Encounter/&CR2_Wind_Snakes_x4_Description	Small air elementals that like to kill.
Encounter/&CR6_Flying_Snakes_x6_Description	Various flying and poisonous reptilians.
Encounter/&CR4_Skarn_Ghouls_x2_Description	Small earth elementals in a bad mood.
Encounter/&CR7_Grimblade_Description	A deadly orc assassin and his escort.
Encounter/&CR8_Tamed_Minotaur_Description	A band of goblins who tamed a powerful minotaur.
